/travel/colombia/volunteer-in-colombia	/travel/colombia
/news/2010/december/australia-gap-year-working-holidays	/travel/australia
/news/2011/january/australia-working-holiday-tips	/travel/australia
/news/2011/may/international-internships-in-australia	/travel/australia
/news/2011/august/australian-outback-work	/travel/australia
/news/2011/november/working-holiday-farm-jobs-in-australia	/travel/australia
/news/2011/january/work-and-travel-opportunities-in-australia	/travel/australia
/news/2011/november/working-holiday-jobs-in-sydney-australia	/travel/australia
/news/2011/march/travel-to-costa-rica-and-study-spanish	/travel/costa-rica
/news/2011/march/study-spanish-at-a-language-school-in-costa-rica	/travel/costa-rica
/travel/costa-rica/teach-in-costa-rica	/travel/costa-rica
/news/2012/august/guatemala-volunteer-holidays	/travel/guatemala
/news/2010/september/guatemala-adventure-vacations	/travel/guatemala
/news/2012/october/inspiring-guatemala-volunteering-programs	/travel/guatemala
/news/2010/may/guatemala-tours-expeditions-yoga-and-volunteering	/travel/guatemala
/news/2010/october/antigua-guatemala-volunteer-opportunities	/travel/guatemala
/travel/guatemala/tours-in-guatemala	/travel/guatemala
/travel/haiti/volunteer-in-haiti	/travel/haiti
/travel/haiti/tours-in-haiti	/travel/haiti
/travel/west-indies/tours-in-west-indies	/travel/west-indies
/travel/west-indies/volunteer-in-west-indies	/travel/west-indies
/travel/tobago/volunteer-in-tobago	/travel/tobago
/travel/tobago/tours-in-tobago	/travel/tobago
/travel/trinidad/tours-in-trinidad	/travel/trinidad
/travel/trinidad/volunteer-in-trinidad	/travel/trinidad
/travel/panama/tours-in-panama	/travel/panama
/travel/panama/volunteer-in-panama	/travel/panama
/travel/nicaragua/volunteer-in-nicaragua	/travel/nicaragua
/travel/nicaragua/tours-in-nicaragua	/travel/nicaragua
/travel/mexico/tours-in-mexico	/travel/mexico
/travel/mexico/teach-in-mexico	/travel/mexico
/news/2010/august/europe-voluntary-work-programs-gap-year-meaningful-travel-ideas	/continent/europe
/news/2011/march/volunteering-in-europe	/continent/europe
/news/2011/march/tefl-teaching-jobs-europe	/continent/europe
/news/2011/january/europe-adventure-travel-ideas-work-volunteer-teach-tours-gap-year	/continent/europe
/news/2010/december/volunteer-abroad-eastern-europe-voluntary-work-programs	/continent/europe
/news/2011/april/europe-tefl-english-teaching-jobs	/continent/europe
/news/2011/march/tefl-teaching-jobs-europe	/continent/europe
/news/2012/may/adventure-tours-in-greece-and-turkey	/continent/europe
/news/2011/january/travel-abroad-eastern-europe-trips-work-volunteer-teach-tours	/continent/europe
/travel/tours-in-jamaica	/travel/jamaica
/news/2011/march/travel-spiritual-tours-in-central-america	/continent/central-america
/news/2011/january/central-america-adventure-trips	/continent/central-america
/news/2010/september/travel-latin-america-volunteer-travel-holidays	/continent/central-america
/news/2011/january/south-america-adventure-travel-ideas	/continent/south-america
/news/2011/april/central-america-travel-and-teach-english	/continent/central-america
/news/2011/march/travel-and-teach-in-central-and-south-america	/continent/south-america
/news/2011/april/south-america-english-teaching-holiday-jobs	/continent/south-america
/news/2011/march/south-america-work-and-travel-programs	/continent/south-america
/news/2011/february/usa-adventure-holidays	/country/united-states
/news/2011/july/peru-inca-trail-volunteer-projects	/travel/peru
/travel/albania/tours-in-albania	/travel/albania
/travel/albania/volunteer-in-albania	/travel/albania
/travel/austria/volunteer-in-austria	/travel/austria
/travel/austria/tours-in-austria	/travel/austria
/travel/belgium/tours-in-belgium	/travel/belgium
/travel/belgium/volunteer-in-belgium	/travel/belgium
/travel/bosnia/tours-in-bosnia	/travel/bosnia
/travel/bosnia/volunteer-in-bosnia	/travel/bosnia
/travel/bulgaria/tours-in-bulgaria	/travel/bulgaria
/travel/bulgaria/volunteer-in-bulgaria	/travel/bulgaria
/travel/croatia/tours-in-croatia	/travel/croatia
/travel/croatia/volunteer-in-croatia	/travel/croatia
/travel/cyprus/tours-in-cyprus	/travel/cyprus
/travel/cyprus/volunteer-in-cyprus	/travel/cyprus
/travel/czech-republic/tours-in-czech-republic	/travel/czech-republic
/travel/czech-republic/volunteer-in-czech-republic	/travel/czech-republic
/travel/denmark/tours-in-denmark	/travel/denmark
/travel/denmark/volunteer-in-denmark	/travel/denmark
/travel/finland/tours-in-finland	/travel/finland
/travel/finland/volunteer-in-finland	/travel/finland
/travel/germany/tours-in-germany	/travel/germany
/travel/germany/volunteer-in-germany	/travel/germany
/travel/france/tours-in-france	/travel/france
/travel/france/volunteer-in-france	/travel/france
/travel/greece/tours-in-greece	/travel/greece
/travel/greece/volunteer-in-greece	/travel/greece
/travel/hungary/volunteer-in-hungary	/travel/hungary
/travel/hungary/tours-in-hungary	/travel/hungary
/travel/iceland/volunteer-in-iceland	/travel/iceland
/travel/iceland/tours-in-iceland	/travel/iceland
/travel/ireland/volunteer-in-ireland	/travel/ireland
/travel/ireland/tours-in-ireland	/travel/ireland
/travel/italy/tours-in-italy	/travel/italy
/travel/italy/volunteer-in-italy	/travel/italy
/travel/kosovo/tours-in-kosovo	/travel/kosovo
/travel/kosovo/volunteer-in-kosovo	/travel/kosovo
/travel/latvia/tours-in-latvia	/travel/latvia
/travel/latvia/volunteer-in-latvia	/travel/latvia
/travel/lithuania/tours-in-lithuania	/travel/lithuania
/travel/lithuania/volunteer-in-lithuania	/travel/lithuania
/travel/malta/volunteer-in-malta	/travel/malta
/travel/malta/tours-in-malta	/travel/malta
/travel/moldova/tours-in-moldova	/travel/moldova
/travel/moldova/volunteer-in-moldova	/travel/moldova
/travel/netherlands/tours-in-netherlands	/travel/netherlands
/travel/netherlands/volunteer-in-netherlands	/travel/netherlands
/travel/norway/tours-in-norway	/travel/norway
/travel/norway/volunteer-in-norway	/travel/norway
/travel/poland/tours-in-poland	/travel/poland
/travel/poland/volunteer-in-poland	/travel/poland
/travel/portugal/tours-in-portugal	/travel/portugal
/travel/portugal/volunteer-in-portugal	/travel/portugal
/travel/romania/tours-in-romania	/travel/romania
/travel/romania/volunteer-in-romania	/travel/romania
/travel/russia/tours-in-russia	/travel/russia
/travel/russia/volunteer-in-russia	/travel/russia
/travel/serbia/tours-in-serbia	/travel/serbia
/travel/serbia/volunteer-in-serbia	/travel/serbia
/travel/spain/tours-in-spain	/travel/spain
/travel/spain/volunteer-in-spain	/travel/spain
/travel/sweden/tours-in-sweden	/travel/sweden
/travel/sweden/volunteer-in-sweden	/travel/sweden
/travel/switzerland/tours-in-switzerland	/travel/switzerland
/travel/switzerland/volunteer-in-switzerland	/travel/switzerland
/travel/tenerife/tours-in-tenerife	/travel/tenerife
/travel/tenerife/volunteer-in-tenerife	/travel/tenerife
/travel/turkey/tours-in-turkey	/travel/turkey
/travel/turkey/volunteer-in-turkey	/travel/turkey
/travel/ukraine/tours-in-ukraine	/travel/ukraine
/travel/ukraine/volunteer-in-ukraine	/travel/ukraine
/travel/united-kingdom/tours-in-united-kingdom	/travel/united-kingdom
/travel/united-kingdom/volunteer-in-united-kingdom	/travel/united-kingdom
/travel/galapagos-islands/volunteer-in-galapagos-islands	/travel/galapagos-islands
/news/2013/february/holiday-volunteering-in-galapagos	/travel/galapagos-islands
/news/2011/march/galapagos-volunteer-vacations	/travel/galapagos-islands
/news/2011/march/galapagos-volunteer-opportunities	/travel/galapagos-islands
/news/2011/march/multi-activity-adventure-holidays-abroad	/activity/adventure-holidays
/news/2011/march/family-tours-abroad	/activity/travel-tours
/news/2011/november/adventure-overland-tours-in-africa-the-middle-east-and-south-america	/activity/travel-tours
/news/2011/july/egypt-tours-experience-the-arab-spring-first-hand	/activity/travel-tours
/news/2011/august/group-travel-and-tour-opportunities-abroad	/activity/travel-tours
/news/2011/june/travel-backpacker-tours-overseas	/activity/travel-tours
/news/2011/january/north-america-canada-adventure-travel-ideas	/travel/canada
/news/2011/march/canada-adventure-holiday-ideas	/travel/canada
/news/2012/july/canada-holiday-adventure-travel	/travel/canada
/news/2011/april/usa-travel-and-tours-5-american-city-trips	/travel/united-states
/news/2011/february/budget-tours-abroad	/activity/travel-tours
/news/2011/january/north-america-adventure-travel-ideas-work-volunteer-teach-tours-gap-year	/continent/north-america
/news/2010/december/2013-2014-adventure-tours-abroad	/activity/travel-tours
/news/2010/december/travel-abroad-activity-holidays-adventure-tours-expeditions-treks-overseas	/activity/travel-tours
/news/2011/january/travel-abroad-japan-kyoto-tours	/travel/japan
/news/2011/january/travel-abroad-china-trips-beijing-tours	/travel/china
/news/2010/august/adventure-tours-overland-trips-south-america-africa-middle-east-gap-year-travel	/activity/travel-tours
/news/2010/october/travel-christmas-and-new-year-adventure-tours-abroad	/activity/travel-tours
/news/2009/august/travel-small-group-adventure-overland-tours-safaris-abroad	/activity/travel-tours
/news/2010/november/asia-and-latin-america-adventure-tours	/activity/travel-tours
/news/2011/january/travel-abroad-adventure-trips-wildlife-tours	/activity/wildlife-holidays
/news/2010/january/china-gap-year	/travel/china
/news/2010/september/asia-china-internships-voluntary-work-experience-abroad	/travel/china
/news/2010/april/china-gapyear-careerbreak-volunteering-sunrise-international	/travel/china
/news/2011/may/family-volunteer-projects-china	/travel/china
/travel/israel/tours-in-israel	/travel/israel
/travel/israel/volunteer-in-israel	/travel/israel
/news/2011/april/asia-tefl-teaching-work-in-singapore	/travel/singapore
/travel/singapore/volunteer-in-singapore	/travel/singapore
/travel/laos/tours-in-laos	/travel/laos
/travel/laos/volunteer-in-laos	/travel/laos
/travel/malaysia/tours-in-malaysia	/travel/malaysia
/travel/malaysia/volunteer-in-malaysia	/travel/malaysia
/travel/malaysia/travel-tips-malaysia	/travel/malaysia
/travel/philippines/volunteer-in-philippines	/travel/philippines
/travel/philippines/tours-in-philippines	/travel/philippines
/travel/tibet/volunteer-in-tibet	/travel/tibet
/travel/tibet/tours-in-tibet	/travel/tibet
/news/2010/september/travel-asia-gap-year-tibet-lhasa-information-tours	/travel/tibet
/news/2010/september/travel-gap-year-tibet-overland-tours-adventure-holiday	/travel/tibet
/travel/india/tours-in-india	/travel/india
/travel/india/travel-tips-india	/travel/india
/news/2010/august/learn-a-new-language-chinese-mandarin-basic-phrases-courses-travel	/travel/china
/news/2010/november/internships-abroad-shanghai-china-work-experience-asia	/travel/china
/news/2010/november/internships-abroad-beijing-china-work-experience-asia	/travel/china
/news/2011/october/china-teaching-internship-january-2012	/travel/china
/news/2010/november/internships-abroad-hong-kong-china-work-experience-asia	/travel/china
/news/2010/april/bunac-tefl-course-teaching-work-china	/travel/china
/travel/vietnam/tours-in-vietnam	/travel/vietnam
/news/2011/march/paid-tefl-teaching-vietnam-south-east-asia	/travel/vietnam
/travel/vietnam/travelling-by-motorbike-in-vietnam	/news/2013/february/an-experience-of-travelling-by-motorbike-in-vietnam
/travel/sri-lanka/what-to-expect-from-traveling-in-sri-lanka	/travel/sri-lanka
/travel/sri-lanka/volunteer-in-sri-lanka	/travel/sri-lanka
/travel/thailand/tours-in-thailand	/travel/thailand
/news/2011/january/nepal-construction-volunteer-projects	/travel/nepal
/news/2011/july/volunteer-teaching-projects-in-india-and-nepal	/travel/nepal
/travel/nepal/tours-in-nepal	/travel/nepal
/travel/nepal/volunteer-in-nepal	/travel/nepal
/news/2011/april/backpacking-volunteer-programmes-in-nepal	/travel/nepal
/news/2011/april/tefl-teaching-work-in-russia	/travel/russia
/travel/switzerland/volunteer-in-switzerland	/travel/switzerland
/travel/switzerland/working-holidays-in-switzerland	/travel/switzerland
/travel/switzerland/tours-in-switzerland	/travel/switzerland
/news/2010/december/volunteer-abroad-romania	/travel/romania
/news/2012/february/romania-childcare-volunteer-projects	/travel/romania
/news/2012/march/romania-volunteer-teaching-work	/travel/romania
/travel/romania/travel-tips-romania	/travel/romania
/news/2011/april/tefl-teaching-english-work-in-romania	/travel/romania
/news/2011/april/portugal-tefl-teaching-work	/travel/portugal
/news/2011/march/summer-volunteer-projects-abroad	/category/volunteer
/news/2011/march/spring-and-winter-short-term-volunteer-projects-abroad	/category/volunteer
/news/2011/august/travel-see-the-world-and-volunteer-to-make-a-difference	/category/volunteer
/news/2011/july/fun-volunteer-projects-overseas	/category/volunteer
/news/2011/november/inspired-travel-volunteer-breaks	/category/volunteer
/news/2011/november/inspired-family-travel-breaks-abroad	/activity/family-holidays
/news/2011/june/find-2013-volunteer-projects-overseas	/category/volunteer
/news/2011/march/hiking-tours-abroad	/activity/travel-tours
/news/2011/november/inspired-travel-teaching-projects-abroad	/category/volunteer
/news/2011/june/volunteer-projects-for-families	/category/volunteer
/news/2010/december/travel-abroad-city-day-tours-overseas	/activity/travel-tours
/news/2011/february/travel-abroad-destinations	/country
/news/2011/january/ethical-travel-ecotourism-sustainable-travel	/activity/travel-tours
/news/2011/january/travel-abroad-cycling-holidays	/activity/cycling-holidays
/news/2011/february/travel-abroad-tour-awards	/activity/travel-tours
/news/2011/january/travel-abroad-walking-holidays-overseas	/activity/travel-tours
/news/2010/december/travel-2013-2014-adventure-overland-trips-and-tours-abroad	/activity/travel-tours
/news/2011/january/travel-abroad-trekking-holidays-overseas	/activity/travel-tours
/news/2011/march/walking-holidays-abroad	/activity/travel-tours
/news/2011/april/new-year-volunteer-and-travel-opportunities	/category/volunteer
/news/2011/november/diverse-volunteer-projects-overseas	/category/volunteer
/news/2011/august/voluntary-work-projects-abroad	/category/volunteer
/news/2011/august/short-term-volunteer-projects-overseas	/category/volunteer
/news/2011/august/inspiring-ideas-for-volunteering-overseas	/category/volunteer
/news/2011/april/volunteer-projects-overseas	/category/volunteer
/news/2010/april/find-free-low-cost-volunteering-programs-overseas	/category/volunteer
/news/2011/january/family-volunteering-holidays-abroad	/category/volunteer
/news/2010/october/volunteer-abroad-why-volunteer-overseas	/category/volunteer
/news/2011/january/responsible-volunteer-travel	/category/volunteer
/news/2011/february/international-volunteer-placements-abroad	/category/volunteer
/news/2011/march/free-volunteering-abroad-programs	/category/volunteer
/news/2011/january/international-volunteer-projects-overseas	/category/volunteer
/news/2011/january/volunteer-abroad-honeymoon-travel-voluntary-work-ideas	/category/volunteer
/news/2011/january/volunteer-abroad-voluntourism-on-the-up	/category/volunteer
/news/2011/november/thousands-of-uk-youngsters-are-heading-abroad-to-volunteer	/category/volunteer
/news/2011/april/under-18-volunteer-projects-overseas	/category/volunteer
/news/2011/april/older-retirement-volunteer-projects-overseas	/category/volunteer
/news/2011/march/gap-year-why-pay-to-volunteer-abroad	/category/volunteer
/news/2011/march/gap-year-one-month-volunteer-abroad	/category/volunteer
/news/2011/march/gap-year-volunteering-trips-abroad	/category/volunteer
/news/2011/august/the-volunteer-inspiring-volunteers-via-film	/category/volunteer
/news/2011/april/volunteer-with-animals-abroad	/activity/animal-volunteer-projects
/news/2011/january/travel-abroad-cruise-trips-overseas	/activity/travel-tours
/news/2011/january/responsible-travel	/activity/travel-tours
/news/2011/january/travel-abroad-culture-tours-trips-overseas	/activity/travel-tours
/news/2011/january/responsible-vacations-abroad	/activity/travel-tours
/news/2011/january/travel-abroad-family-holidays	/activity/travel-tours
/news/2010/december/travel-book-hotel-accommodation-abroad	/travel-accommodation
/news/2011/january/responsible-travel-programs	/activity/travel-tours
/travel/ireland/travel-tips-ireland	/travel/ireland
/travel/ireland/tours-in-ireland	/travel/ireland
/travel/ireland/volunteer-in-ireland	/travel/ireland
/travel/ireland/working-holidays-in-ireland	/travel/ireland
/news/2010/october/work-abroad-2011-internships-jobs-live-and-work-in-ireland	/travel/ireland
/news/2011/february/dentistry-volunteer-opportunities	/search/dental-volunteer-projects
/news/2011/march/dental-volunteer-programs-abroad	/search/dental-volunteer-projects
/news/2011/march/dental-volunteer-work-abroad	/search/dental-volunteer-projects
/news/2012/august/dental-volunteer-work-experience-abroad	/search/dental-volunteer-projects
/news/2011/november/2013-dental-volunteer-projects-abroad	/search/dental-volunteer-projects
/news/2011/may/volunteer-medicine-work-experience-overseas	/activity/medical-volunteering
/news/2011/may/medical-health-volunteer-work-programmes-in-argentina	/activity/medical-volunteering
/news/2011/february/medical-healthcare-dental-volunteer-work-experience-overseas	/search/dental-volunteer-projects
/news/2012/september/international-dental-volunteer-programs-abroad	/search/dental-volunteer-projects
/news/2011/february/medical-healthcare-dental-elective-voluntary-work-abroad	/search/dental-volunteer-projects
/news/2012/august/community-development-volunteer-programs-abroad	/activity/community-projects
/news/2012/october/how-to-find-conservation-volunteer-travel-program	/activity/conservation-projects
/news/2011/february/medical-healthcare-dental-work-experience-in-the-developing-world	/search/dental-volunteer-projects
/news/2011/january/health-care-electives-in-africa-asia-south-america	/activity/medical-volunteering
/news/2010/december/volunteer-abroad-medicine-work-experience-placements-overseas	/activity/medical-volunteering
/news/2010/december/medical-elective-placements-abroad-medicine-gap-year-hospital-dentistry-physiopheraphy-work-experience-overseas	/activity/medical-volunteering
/news/2011/april/medicine-gap-year-abroad	/activity/medical-volunteering
/news/2010/november/volunteer-abroad-relevant-medicine-work-experience-overseas	/activity/medical-volunteering
/news/2010/september/why-is-medical-work-experience-so-important-gap-year-healthcare	/activity/medical-volunteering
/news/2010/december/volunteer-abroad-medical-hiv-aids-orphanage-voluntary-work-experience-programs	/activity/medical-volunteering
/news/2010/december/volunteer-abroad-summer-healthcare-gap-year-work-experience-overseas	/activity/medical-volunteering
/news/2010/december/volunteer-abroad-medicine-health-care-voluntary-work-experience-africa	/activity/medical-volunteering
/news/2010/december/medical-work-experience-pre-healthcare-gap-year-voluntary-medicine-work-projects-abroad	/activity/medical-volunteering
/news/2011/february/medical-electives-healthcare-work-experience-abroad-medicine-access-courses	/activity/medical-volunteering
/news/2011/february/medical-healthcare-programs-public-health-projects-abroad	/activity/medical-volunteering
/news/2011/april/clinical-medicine-work-experience-abroad	/activity/medical-volunteering
/news/2011/april/medical-careers-rejection-for-medicine-gap-year	/activity/medical-volunteering
/news/2011/february/medical-electives-abroad-advice	/activity/medical-volunteering
/news/2011/february/medical-electives-global-health-placements	/activity/medical-volunteering
/news/2011/february/medical-electives-ukcat-uk-clinical-aptitude-test	/activity/medical-volunteering
/news/2011/april/health-care-nurse-work-experience-placements-abroad	/activity/medical-volunteering
/news/2011/may/volunteer-medicine-work-experience-overseas	/activity/medical-volunteering
/news/2011/may/graduate-entry-medical-placements	/activity/medical-volunteering
/news/2011/april/clinical-nursing-work-experience-overseas	/activity/medical-volunteering
/news/2011/january/medical-electives-abroad-public-health-volunteering-overseas	/activity/medical-volunteering
/news/2011/january/medical-healthcare-work-experience-train-to-become-a-doctor	/activity/medical-volunteering
/news/2011/march/clinical-psychology-work-experience-abroad	/activity/medical-volunteering
/news/2011/january/medical-electives-healthcare-psychology-work-experience-abroad	/activity/medical-volunteering
/news/2010/september/volunteering-for-nhs-work-experience	/activity/medical-volunteering
/news/2010/april/working-holiday-visa-information-jobs-gap-year-holiday	/activity/working-holiday-jobs
/news/2011/june/paid-working-holiday-jobs	/activity/working-holiday-jobs
/news/2010/october/scuba-diving-padi-sidemount-diver-course-unique-udc-in-honduras	/travel/honduras
/travel/honduras/scuba-diving-in-honduras	/travel/honduras
/travel/honduras/volunteer-in-honduras	/travel/honduras
/travel/honduras/tours-in-honduras	/travel/honduras
/company/out-in-africa-encounters-horseback-safaris-voluneering	/company/out-in-africa-encounters
/news/2011/may/family-volunteer-projects-china	/travel/china
/news/2010/april/china-gapyear-careerbreak-volunteering-sunrise-international	/travel/china
/news/2010/january/china-gap-year	/travel/china
/news/2010/september/asia-china-internships-voluntary-work-experience-abroad	/travel/china
/news/2011/march/paid-tefl-teaching-vietnam-south-east-asia	/travel/vietnam
/news/2011/may/malta-gap-year-volunteer-work-medical-health-programmes	/activity/medical-volunteering
/travel/bahamas/volunteer-in-bahamas	/travel/bahamas
/travel/belize/volunteer-in-belize	/travel/belize
/travel/cuba/volunteer-in-cuba	/travel/cuba
/travel/cuba/tours-in-cuba	/travel/cuba
/travel/costa-rica/travel-tips-costa-rica	/travel/costa-rica
/travel/costa-rica/learn-spanish-in-costa-rica	/travel/costa-rica
/travel/costa-rica/volunteer-in-costa-rica	/travel/costa-rica
/travel/cuba/havana	/travel/cuba
/travel/guatemala/volunteer-in-guatemala	/travel/guatemala
/travel/jamaica/volunteer-in-jamaica	/travel/jamaica
/news/2012/october/inspiring-mauritius-volunteering-opportunities	/travel/mauritius
/news/2013/may/mauritius-where-family-memories-are-made	/travel/mauritius
/travel/mexico/travel-tips-mexico	/travel/mexico
/travel/mexico/volunteer-in-mexico	/travel/mexico
/travel/ecuador/working-holidays-in-ecuador	/travel/ecuador
/travel/ecuador/learn-spanish-in-ecuador	/travel/ecuador
/travel/ecuador/volunteer-in-ecuador	/travel/ecuador
/travel/ecuador/teach-in-ecuador	/travel/ecuador
/news/2010/may/ecuador-working-holiday-jobs	/travel/ecuador
/travel/chile/volunteer-in-chile	/travel/chile
/travel/chile/teach-in-chile	/travel/chile
/travel/argentina/tours-in-argentina	/travel/argentina
/travel/argentina/teach-in-argentina	/travel/argentina
/travel/argentina/volunteer-in-argentina	/travel/argentina
/news/2011/march/travel-and-learn-spanish-in-argentina	/travel/argentina
/news/2011/april/study-spanish-in-buenos-aires-argentina	/travel/argentina
/travel/argentina/learn-spanish-in-argentina	/travel/argentina
/travel/brazil/tours-in-brazil	/travel/brazil
/travel/brazil/teach-in-brazil	/travel/brazil
/travel/brazil/working-holidays-in-brazil	/travel/brazil
/travel/brazil/learn-brazilian-portuguese-in-brazil	/travel/brazil
/travel/brazil/sao-paulo/best-things-to-see-and-do-in-sao-paulo	/travel/brazil/sao-paulo
/travel/australia/tours-in-australia	/travel/australia
/travel/australia/scuba-diving-in-australia	/travel/australia
/travel/australia/volunteer-in-australia	/travel/australia
/travel/australia/working-holidays-in-australia	/travel/australia
/travel/australia/great-australian-road-trips-10-ultimate-pit-stops	/travel/australia
/travel/australia/travel-tips-australia	/travel/australia
/travel/australia/top-10-things-to-do-and-places-to-see-in-australia	/travel/australia
/news/2011/january/australia-adventure-travel-ideas	/travel/australia
/news/2012/august/australia-travel-opportunities-festivals	/travel/australia
/news/2010/september/australia-work-adventures-down-under	/travel/australia
/news/2010/september/australia-cultural-exchange-for-15-to-19-year-olds	/travel/australia
/travel/new-zealand/travel-tips-new-zealand 	/travel/new-zealand
/news/2011/march/work-and-travel-in-new-zealand	/travel/new-zealand
/travel/new-zealand/volunteer-in-new-zealand	/travel/new-zealand
/travel/new-zealand/tours-in-new-zealand	/travel/new-zealand
/news/2011/march/new-zealand-adventure-holidays	/travel/new-zealand
/travel/new-zealand/south-island	/travel/new-zealand
/travel/new-zealand/north-island	/travel/new-zealand
/travel/new-zealand/best-things-to-see-and-do-in-new-zealand	/travel/new-zealand
/travel/cambodia/travel-tips-cambodia	/travel/cambodia
/travel/cambodia/volunteer-in-cambodia	/travel/cambodia
/travel/cambodia/travel-tips-cambodia	/travel/cambodia
/travel/cambodia/weather-and-best-time-to-visit-cambodia	/travel/cambodia
/travel/cambodia/money-and-daily-budget	/travel/cambodia
/travel/cambodia/health-and-safety-advice-for-cambodia	/travel/cambodia
/travel/cambodia/useful-khmer-cambodian-words-and-phrases	/travel/cambodia
/travel/cambodia/best-things-to-see-and-do-in-cambodia	/travel/cambodia
/news/2013/january/angkor-watt-siem-riep-cambodia-travel-experiences	/travel/cambodia
/travel/thailand/working-holidays-in-thailand	/travel/thailand
/news/2011/march/tefl-courses-and-teaching-work-in-thailand	/travel/thailand
/travel/thailand/teach-in-thailand	/travel/thailand
/travel/vietnam/visa-requirements-for-vietnam	/travel/vietnam
/travel/vietnam/health-and-safety-advice-for-vietnam	/travel/vietnam
/travel/vietnam/money-and-daily-budget	/travel/vietnam
/travel/vietnam/useful-vietnamese-phrases	/travel/vietnam
/travel/vietnam/best-things-to-see-and-do-in-vietnam	/travel/vietnam
/travel/vietnam/scuba-diving-in-vietnam	/travel/vietnam
/travel/vietnam/volunteer-in-vietnam	/travel/vietnam
/travel/vietnam/travel-tips-vietnam	/travel/vietnam
/travel/vietnam/travel-tips-vietnam	/travel/vietnam
/travel/thailand/thailand-weather-and-best-time-to-visit	/travel/thailand
/travel/thailand/visa-requirements-for-thailand	/travel/thailand
/travel/thailand/skydiving-in-thailand to /news/2013/april/reach-the-roof-of-the-world-and-consider-going-sky-diving-in-thailand	/travel/thailand
/travel/thailand/money-and-daily-budget	/travel/thailand
/travel/thailand/health-and-safety-advice-for-thailand	/travel/thailand
/travel/thailand/scuba-diving-in-thailand	/travel/thailand
/travel/thailand/best-things-to-see-and-do-in-thailand	/travel/thailand
/travel/thailand/volunteer-in-thailand	/travel/thailand
/travel/thailand/travel-tips-thailand	/travel/thailand
/news/2010/may/south-africa-jobs-working-riding-holiday-gap-year-travel	/travel/south-africa
/travel/south-africa/working-holidays-in-south-africa	/travel/south-africa
/travel/south-africa/volunteer-in-south-africa	/travel/south-africa
/travel/kenya/teach-in-kenya	/travel/kenya
/travel/kenya/volunteer-in-kenya	/travel/kenya
/travel/tanzania/volunteer-in-tanzania	/travel/tanzania
/travel/china/teach-in-china	/travel/china
/travel/china/best-things-to-see-and-do-in-china	/travel/china
/travel/china/volunteer-in-china	/travel/china
/travel/china/travel-tips-china	/travel/china
/travel/india/volunteer-in-india	/travel/india
/travel/indonesia/tours-in-indonesia	/travel/indonesia
/news/2012/october/inspiring-indonesia-volunteering-programs	/travel/indonesia
/travel/indonesia/volunteer-in-indonesia	/travel/indonesia
/travel/indonesia/travel-tips-indonesia	/travel/indonesia
/travel/philippines/travel-tips-philippines	/travel/philippines
/travel/philippines/scuba-diving	/travel/philippines
/travel/nepal/top-5-things-to-do-in-nepal	/travel/nepal
/travel/brazil/highlights-of-beautiful-brazil	/travel/brazil
/travel/brazil/travel-tips-brazil	/travel/brazil
/continent/central-america/travel-tour	/continent/central-america
/continent/central-america/scuba-diving-in-central-america	/continent/central-america
/continent/central-america/volunteer	/continent/central-america
/continent/central-america/teach	/continent/central-america
/continent/central-america/internships	/continent/central-america
/continent/central-america/work	/continent/central-america
/continent/central-america/learn-spanish-in-central-america	/continent/central-america
/continent/central-america/travel-tips-central-america	/continent/central-america
/continent/north-america/travel-tour	/continent/north-america
/continent/north-america/teach	/continent/north-america
/continent/north-america/volunteer	/continent/north-america
/news/2010/december/volunteer-abroad-north-america-voluntary-work-programs	/continent/north-america
/continent/north-america/work	/continent/north-america
/continent/north-america/travel-tips-north-america	/continent/north-america
/continent/north-america/natural-wonders-of-north-america	/continent/north-america
/continent/africa/travel-tour	/continent/africa
/continent/africa/teach	/continent/africa
/news/2010/july/africa-travel-photo-safaris-overland-tours	/continent/africa
/continent/africa/volunteer	/continent/africa
/continent/asia/teach	/continent/asia
/continent/asia/travel-tour	/continent/asia
/continent/asia/volunteer	/continent/asia
/continent/asia/work	/continent/asia
/continent/asia/scuba-diving-in-asia	/continent/asia
/continent/asia/travel-tips-asia	/continent/asia
/continent/south-america/teach	/continent/south-america
/continent/south-america/work	/continent/south-america
/continent/south-america/travel-tour	/continent/south-america
/continent/south-america/internships	/continent/south-america
/news/2010/november/travel-abroad-south-america-bus-pass-tours-trips	/continent/south-america
/continent/south-america/volunteer	/continent/south-america
/continent/south-america/travel-tips-south-america	/continent/south-america
/continent/south-america/learn-spanish-in-south-america	/continent/south-america
/continent/south-america/learn-spanish-in-south-america	/continent/south-america
/news/2011/january/jobs-abroad-working-holidays-2011	/activity/working-holiday-jobs
/news/2011/february/paid-work-programmes-abroad-in-europe-and-north-america	/activity/working-holiday-jobs
/news/2011/october/2013-summer-camp-jobs-in-the-usa	/travel/united-states
/news/2010/december/work-abroad-australia-canada-new-zealand-usa-working-holiday-jobs	/activity/working-holiday-jobs
/travel/canada/travel-tips-canada	/travel/canada
/travel/canada/volunteer-in-canada	/travel/canada
/news/2012/july/canadian-rockies-adventure-tours	/travel/canada
/news/2012/july/canada-niagara-falls-adventure-tours	/travel/canada
/news/2011/june/discounted-canada-tours	/travel/canada
/news/2011/april/canada-tours-discounted-trips-north-america	/travel/canada
/news/2010/december/canada-alaska-adventure-tours	/travel/canada
/travel/canada/tours-in-canada	/travel/canada
/news/2011/january/canada-working-holiday-advice	/travel/canada
/news/2011/may/ski-and-snowboard-working-holidays-in-canada	/travel/canada
/news/2011/january/canada-working-holiday-applications-now-open	/travel/canada
/news/2011/april/travel-and-working-holidays-in-canada	/travel/canada
/news/2011/february/canada-summer-working-holidays	/travel/canada
/news/2011/january/winter-working-holidays-in-canada	/travel/canada
/news/2011/may/paid-working-holidays-in-canada	/travel/canada
/news/2011/may/2013-canada-working-holiday-ski-resort-jobs	/travel/canada
/travel/united-states/tours-in-united-states	/travel/united-states
/news/2013/may/backpacking-across-america-where-to-visit-and-why	/travel/united-states
/travel/united-states/volunteer-in-united-states	/travel/united-states
/news/2011/november/2013-usa-dental-work-volunteer-programs	/travel/united-states
/travel/united-states/travel-tips-usa	/travel/united-states
/news/2012/january/apply-for-usa-summer-camp-jobs-in-2013	/travel/united-states
/travel/united-states/working-holidays-in-united-states	/travel/united-states
/news/2011/november/summer-work-in-america	/travel/united-states
/news/2011/may/advice-for-job-hunting-in-america	/travel/united-states
/news/2011/january/jobs-in-america	/travel/united-states
/continent/europe/learn-spanish-in-europe	/continent/europe
/continent/europe/volunteer	/continent/europe
/continent/europe/teach	/continent/europe
/continent/europe/travel-tour	/continent/europe
/continent/europe/best-things-to-see-and-do-in-europe	/continent/europe
/continent/europe/travel-tips-europe	/continent/europe
/continent/europe/work	/continent/europe
/news/2013/june/hampsire-mums-join-forces-to-help-new-parents-take-time-out-to-enjoy-their-times-with-their-babies	/travel/united-kingdom
/news/2011/april/tefl-english-teaching-work-in-spain	/travel/spain
/news/2010/july/spain-work-volunteer-gap-year-travel-programmes	/travel/spain
/news/2011/march/study-and-work-in-spain	/travel/spain
/travel/spain/best-things-to-see-and-do-in-spain	/travel/spain
/travel/spain/volunteer-in-spain	/travel/spain
/travel/spain/travel-tips-spain	/travel/spain
/travel/spain/scuba-diving-in-spain	/travel/spain
/travel/italy/working-holidays-in-italy	/travel/italy
/travel/italy/teach-in-italy	/travel/italy
/news/2011/april/tefl-english-teaching-work-in-italy	/travel/italy
/news/2011/may/italy-volunteer-projects-for-over-50s	/travel/italy
/news/2011/february/europe-travel-italy-tours-venice-rome	/travel/italy
/travel/italy/travel-tips-italy	/travel/italy
/news/2011/may/africa-conservation-volunteer-projects-with-turtles	/search/volunteer-turtles
/news/2012/march/tiger-conservation-volunteer-projects-and-petition	/search/volunteer-tigers
/news/2011/october/support-gorilla-conservation-projects-in-the-dr-congo	/search/volunteer-gorillas
/news/2011/june/volunteer-marine-conservation-projects-more-important-than-ever	/search/marine-conservation-volunteer-holidays
/news/2010/september/caribbean-scuba-diving-certification-courses	/travel/caribbean
/news/2012/august/scuba-diving-lessons-caribbean	/travel/caribbean
/news/2010/march/travel-and-learn-to-scuba-dive-in-the-caribbean	/travel/caribbean
/news/2010/august/caribbean-scuba-diving-jobs	/travel/caribbean
/news/2011/january/south-east-asia-learn-to-scuba-dive	/activity/scuba-diving
/news/2011/march/learn-to-scuba-dive-in-thailand	/activity/scuba-diving
/news/2011/november/learn-to-scuba-dive-in-2013	/activity/scuba-diving
/news/2011/february/caribbean-scuba-diving-vacations	/activity/scuba-diving
/travel/peru/volunteer-in-peru	/travel/peru
/travel/peru/learn-spanish-in-peru	/travel/peru
/travel/peru/travel-tips-peru	/travel/peru
/travel/peru/teach-in-peru	/travel/peru
/travel/peru/tours-in-peru	/travel/peru
/news/2011/march/usa-work-and-travel-free-cheap-things-to-do-on-a-budget	/travel/united-states
/news/2011/february/usa-west-coast-tours-nevada-grand-canyon-monument-valley	/travel/united-states
/news/2011/february/alaska-wildnerness-adventure-holiday-tours	/travel/united-states
/news/2011/february/alaska-holiday-tours	/travel/united-states
/news/2011/november/summer-jobs-in-the-usa	/travel/united-states
/news/2011/february/north-america-travel-usa-tours-chicago-huston	/travel/united-states
/news/2011/january/north-america-work-internships-usa	/travel/united-states
/news/2011/january/travel-abroad-usa-adventure-trip-north-america-work-volunteer-teach-tours-gap-year	/travel/united-states
/news/2010/december/travel-abroad-usa-overland-tours-and-adventure-trips-north-america	/travel/united-states
/news/2011/february/usa-summer-jobs-america-travel-programs	/travel/united-states
/news/2010/october/usa-conservation-volunteer-projects-north-america	/travel/united-states
/news/2010/september/travel-abroad-united-states-road-trips-adventure-gap-year-tours-usa-north-america	/travel/united-states
/news/2010/december/new-zealanders-work-and-travel-in-the-usa	/travel/united-states
/news/2010/december/find-work-abroad-in-alaska	/travel/united-states
/news/2011/january/north-america-work-and-travel-programs-usa-canada	/travel/united-states
/news/2010/december/work-abroad-north-america-working-holiday-jobs-usa-alaska	/travel/united-states
/news/2010/december/find-work-and-volunteer-programs-around-the-world	/category/volunteer
/news/2011/december/take-a-tefl-course-and-teach-english-overseas-in-2012	/activity/tefl-courses
/news/2012/september/take-a-gap-year-and-teach-english-abroad	/activity/gap-year
/news/2011/january/book-hostel-accommodation-find-cheap-rooms-for-backpackers-students-travellers	/travel-accommodation
/news/2013/january/2013-summer-volunteer-trips-dates-announced	/category/volunteer
/news/2012/february/teach-and-travel-abroad-tefl-courses-discounted-prices	/activity/tefl-courses
/news/2011/april/travel-abroad-10-reasons-to-take-a-gap-year	/activity/gap-year
/news/2010/november/travel-abroad-one-world-365-meaningful-travel-opportunities-overseas	/category/travel-tour
/news/2012/september/adventure-overland-tours-to-turkey-and-iran	/travel/iran
/news/2011/december/holidays-with-a-difference-south-africa-lion-conservation-projects	/search/volunteer-lions
/news/2012/may/mountain-gorilla-adventure-trip-kenya-uganda-rwanda	/continent/africa
/news/2011/january/2013-summer-camp-jobs-usa-canada-north-america	/travel/united-states

