/news/2012/december/travel-fiji-an-archipelago-of-contrasts	/travel/fiji
/news/2012/december/indonesia-yogyakarta-travel-guide	/travel/indonesia/java/yogyakarta
/news/2012/october/learin-to-scuba-dive-in-vietnam	/travel/vietnam/scuba-diving-in-vietnam
/news/2013/january/thailand-koh-pha-ngan-travel-information-and-advice	/travel/thailand/koh-pha-ngan
/news/2012/october/africa-botswana-inspiring-volunteering-programs	/travel/botswana
/news/2011/november/african-volunteer-adventure-in-botswana	/travel/botswana
/news/2011/march/tours-abroad-middle-east-egypt-trips	/travel/egypt
/news/2012/march/volunteering-projects-in-poland	/travel/poland
/news/2011/april/tefl-english-teaching-work-in-poland	/travel/poland
/travel/poland/krakov/travel-tips-krakov	/travel/poland/krakov
/news/2011/february/thailand-travel-and-volunteering-opportunities	/travel/thailand/volunteer-in-thailand
/news/2012/august/thailand-volunteering-work	/travel/thailand/volunteer-in-thailand
/news/2011/april/thailand-elephant-volunteer-holidays	/search/volunteer-elephants
/travel/brazil/rio-de-janeiro/travel-tips-rio-de-janeiro	/travel/brazil/rio-de-janeiro
/news/2011/march/guided-tours-of-the-inca-trail-in-peru	/travel/peru/tours-in-peru
/news/2012/september/brazil-travel-useful-words-and-phrases	/travel/brazil/useful-brazilian-portuguese-words-and-phrases-for-traveling-in-brazil
/guest-articles/5-classic-spanish-recipe-ideas	/news/2013/april/5-classic-spanish-recipe-ideas
/news/2012/september/mozambique-travel-whale-shark-holidays	/travel/mozambique
/news/2012/august/mozambique-whale-shark-conservation-volunteer-travel-opportunities	/travel/mozambique
/guest-articles/make-sure-that-you-play-while-you-work-abroad	/news/2013/april/acclimatising-tips-when-working-abroad
/news/2012/september/mozambique-volunteering-work	/travel/mozambique
/guest-articles/lanzarote-the-ideal-winter-sun-destination	/travel/spain/lanzarote
/news/2011/february/kenya-maasai-volunteer-programs	/travel/kenya/volunteer-in-kenya
/news/2010/december/volunteer-travel-africa-voluntary-work-programs-kenya	/travel/kenya/volunteer-in-kenya
/news/2011/february/inspiring-kenya-volunteering-programs	/travel/kenya/volunteer-in-kenya
/news/2011/march/west-africa-voluntary-work-in-ghana	/travel/ghana
/news/2011/february/ghana-volunteer-responsible-travel-programs	/travel/ghana
/news/2011/february/africa-volunteering-travelopportunities-in-ghana	/travel/ghana
/news/2011/june/study-amharic-and-find-volunteer-projects-in-ethiopia	/travel/ethiopia
/news/2012/october/ehtiopia-volunteer-vacations	/travel/ethiopia
/news/2012/september/peru-tours-and-adventure-travel-opportunities	/news/2012/september/peru-pongo-de-manique-travel-experiences
/news/2011/april/travel-and-study-spanish-in-spain	/travel/spain/learn-spanish-in-spain
/news/2010/october/tefl-foundation-tesol-courses-teach-english-overseas	/category/seasonal-jobs
/news/2011/march/learn-french-and-volunteer-in-benin-africa	/travel/benin
/news/2012/august/a-guide-to-volunteering-in-burma	/travel/myanmar
/news/2012/october/morocco-travel-and-tours	/travel/morocco
/news/2012/march/gambia-volunteer-tourism	/travel/gambia
/news/2011/january/new-zealand-adventure-travel-ideas	/travel/new-zealand
/news/2011/march/new-zealand-small-group-adventure-tours	/travel/new-zealand
/news/2012/october/inspirational-jordan-travel-and-volunteer-programs	/travel/jordan
/news/2012/october/inspiring-swaziland-volunteering-programs	/travel/swaziland
/news/2011/january/teachers-urgently-required-in-the-maldives	/travel/maldives
/news/2011/january/maldives-sports-coaching-voluntary-work-placements	/travel/maldives
/news/2011/january/maldives-tefl-courses-teaching-placements	/travel/maldives
/news/2011/january/work-abroad-hospitality-staff-needed-in-the-maldives	/travel/maldives
/news/2010/december/inspiring-volunteering-programs-in-zambia	/travel/zambia
/news/2010/november/travel-abroad-africa-tours-safaris-tanzania-zanzibar-adventure-trips	/travel/zanzibar
/news/2011/april/take-a-gap-year-in-tanzania-and-travel-to-zanzibar	/travel/zanzibar
/news/2011/november/volunteer-teaching-english-projects-in-zanzibar	/travel/zanzibar
/news/2011/january/volunteering-programs-in-zambia-africa	/travel/zambia
/news/2010/october/volunteer-abroad-with-chimpanzees-in-zambia-africa-animal-conservation-projects	/travel/cameroon
/news/2011/april/wildlife-volunteer-projects-in-africa	/continent/africa
/news/2011/april/cameroon-primate-volunteer-projects-africa	/travel/cameroon
/news/2011/february/conservation-programs-in-cameroon-africa	/travel/cameroon
/news/2010/september/volunteer-programs-in-cameroon-french-africa	/travel/cameroon
/news/2011/march/chile-teach-english	/travel/chile/teach-in-chile
/news/2011/april/chile-teaching-jobs	/travel/chile/teach-in-chile
/news/2011/may/travel-and-teach-in-chile-south-america	/travel/chile/teach-in-chile
/news/2012/august/south-america-colombia-travel-safety-advice	/travel/colombia
/news/2012/september/colombia-travel-highlights	/travel/colombia
/news/2011/february/volunteer-travel-programs-in-colombia	/travel/colombia
/news/2011/february/a-guide-to-volunteering-in-colombia	/travel/colombia
/news/2010/december/a-guide-to-volunteering-in-jamaica	/travel/jamaica
/news/2012/september/inspirational-volunteer-opportunities-in-africa	/continent/africa/volunteer
/news/2012/june/volunteers-needed-in-africa-this-summer	/continent/africa/volunteer
/news/2011/january/africa-volunteer-sports-coaching-projects	/continent/africa/volunteer
/news/2011/february/africa-volunteering-realities-and-delusions	/continent/africa/volunteer
/news/2011/march/africa-volunteer-at-an-orphanage-in-tanzania	/continent/africa/volunteer
/news/2011/january/voluntary-work-africa-popular-volunteering-trips	/continent/africa/volunteer
/news/2011/march/africa-community-teaching-orphanage-volunteer-programmes-in-tanzania	/continent/africa/volunteer
/news/2010/december/africa-travel-and-volunteer-opportunities	/continent/africa/volunteer
/news/2011/august/africa-education-and-elephant-volunteer-projects	/continent/africa/volunteer
/news/2011/april/thinking-about-volunteering-in-africa	/continent/africa/volunteer
/news/2011/january/voluntary-work-abroad-recommended-africa-volunteer-programs	/continent/africa/volunteer
/news/2010/december/volunteer-africa-education-teaching-community-development-programs-kenya-zambia-voluntary-work-projects	/continent/africa/volunteer
/news/2011/february/charity-wildlife-volunteer-programs-in-africa	/continent/africa/volunteer
/news/2010/december/volunteer-teachers-needed-in-africa	/continent/africa/volunteer
/news/2011/august/volunteer-and-teach-in-africa	/continent/africa/volunteer
/news/2011/november/elephant-volunteer-projects-in-africa	/continent/africa/volunteer
/news/2011/march/rhino-volunteer-work-africa	/continent/africa/volunteer
/news/2010/december/travel-abroad-africa-overland-adventure-wildlife-tours-and-safaris	/continent/africa/travel-tour
/news/2010/december/travel-abroad-east-and-southern-africa-adventure-overland-wildlife-photographic-tours-trips-safaris	/continent/africa/travel-tour
/news/2010/november/volunteer-abroad-africa-animal-conservation-programmes	/continent/africa/volunteer
/news/2012/november/what-to-expect-when-volunteering-with-elephants-abroad	/search/volunteer-elephants
/news/2010/september/travel-sierra-leone-volunteer-gap-year-teach-community-projects	/travel/sierra-leone
/news/2011/january/africa-adventure-travel-ideas-work-volunteer-teach-tours-gap-year	/continent/africa
/news/2011/march/conservation-tourism-africa	/continent/africa
/news/2010/november/travel-abroad-southern-africa-meaningful-volunteer-work-tours	/continent/africa/volunteer
/news/2011/january/inspiring-asia-travel-ideas	/continent/asia
/news/2011/january/south-east-asia-travel-ideas-and-opportunities	/continent/asia
/news/2010/december/south-east-asia-travel-cambodia-and-vietnam-holiday-options	/continent/asia
/news/2010/september/travel-and-volunteer-in-asia-thailand-nepal	/continent/asia/volunteer
/news/2010/september/travel-and-volunteer-in-asia-thailand-nepal	/continent/asia/volunteer
/travel/benin/volunteer-in-benin	/travel/benin
/travel/benin/tours-in-benin	/travel/benin
/travel/botswana/volunteer-in-botswana	/travel/botswana 
/travel/botswana/tours-in-botswana	/travel/botswana 
/travel/bukino-faso/volunteer-in-bukino-faso	/travel/bukino-faso
/travel/bukino-faso/tours-in-bukino-faso	/travel/bukino-faso
/travel/cameroon/volunteer-in-cameroon	/travel/cameroon
/travel/cameroon/tours-in-cameroon	/travel/cameroon
/travel/cape-verde/volunteer-in-cape-verde	/travel/cape-verde
/travel/cape-verde/tours-in-cape-verde	/travel/cape-verde
/travel/cote-d-ivoire/volunteer-in-cote-d-ivoire	/travel/cote-d-ivoire
/travel/cote-d-ivoire/tours-in-cote-d-ivoire	/travel/cote-d-ivoire
/travel/egypt/volunteer-in-egypt	/travel/egypt
/travel/egypt/tours-in-egypt	/travel/egypt
/travel/ethiopia/volunteer-in-ethiopia	/travel/ethiopia
/travel/ethiopia/tours-in-ethiopia	/travel/ethiopia
/travel/gambia/volunteer-in-gambia	/travel/gambia
/travel/gambia/tours-in-gambia	/travel/gambia
/travel/ghana/volunteer-in-ghana	/travel/ghana
/travel/ghana/tours-in-ghana	/travel/ghana
/travel/liberia/volunteer-in-liberia	/travel/liberia
/travel/liberia/tours-in-liberia	/travel/liberia
/travel/libya/volunteer-in-libya	/travel/libya
/travel/libya/tours-in-libya	/travel/libya
/travel/madagascar/volunteer-in-madagascar	/travel/madagascar 
/travel/madagascar/tours-in-madagascar	/travel/madagascar 
/travel/malawi/volunteer-in-malawi	/travel/malawi 
/travel/malawi/tours-in-malawi	/travel/malawi 
/travel/mali/volunteer-in-mali	/travel/mali 
/travel/mali/tours-in-mali	/travel/mali 
/travel/mauritania/volunteer-in-mauritania	/travel/mauritania 
/travel/mauritania/tours-in-mauritania	/travel/mauritania 
/travel/morocco/volunteer-in-morocco	/travel/morocco 
/travel/morocco/tours-in-morocco	/travel/morocco 
/travel/mozambique/volunteer-in-mozambique	/travel/mozambique 
/travel/mozambique/tours-in-mozambique	/travel/mozambique 
/travel/namibia/volunteer-in-namibia	/travel/namibia 
/travel/namibia/tours-in-namibia	/travel/namibia 
/travel/nigeria/volunteer-in-nigeria	/travel/nigeria
/travel/nigeria/tours-in-nigeria	/travel/nigeria
/travel/rwanda/volunteer-in-rwanda	/travel/rwanda
/travel/rwanda/tours-in-rwanda	/travel/rwanda
/travel/senegal/volunteer-in-senegal	/travel/senegal 
/travel/senegal/tours-in-senegal	/travel/senegal 
/travel/sierra-leone/volunteer-in-sierra-leone	/travel/sierra-leone
/travel/sierra-leone/tours-in-sierra-leone	/travel/sierra-leone
/travel/swaziland/volunteer-in-swaziland	/travel/swaziland 
/travel/swaziland/tours-in-swaziland	/travel/swaziland 
/travel/togo/volunteer-in-togo	/travel/togo
/travel/togo/tours-in-togo	/travel/togo
/travel/uganda/volunteer-in-uganda	/travel/uganda
/travel/uganda/tours-in-uganda	/travel/uganda
/travel/zambia/volunteer-in-zambia	/travel/zambia
/travel/zambia/tours-in-zambia	/travel/zambia
/travel/zanzibar/volunteer-in-zanzibar	/travel/zanzibar
/travel/zanzibar/tours-in-zanzibar	/travel/zanzibar
/news/2010/november/travel-abroad-africa-adventure-trips-tours-safaris-kenya-tanzania-uganda	/continent/africa
/news/2010/december/gap-year-travel-positive-outlook-for-2011-gap-years	/activity/gap-year
/news/2010/august/gap-year-travel-programmes-volunteer-work-placements-overseas-volunteering-projects-abroad	/activity/gap-year
/news/2010/august/2010-top-travel-destinations-lonely-planet	/country
/news/2010/august/gap-year-volunteering-travel-gapforce-inforamtion-open-day	/activity/gap-year
/news/2010/september/europe-paid-hospitality-work-experience-spain-italy	/travel/spain
/news/2010/september/gap-year-asia-highlights-travel-advice-recommendations	/continent/asia
/news/2010/september/how-should-you-spend-your-medical-gap-year	/activity/gap-year
/news/2010/october/volunteer-hiv-aids-projects-abroad	/category/volunteer
/news/2010/september/travel-gap-year planning-advice-guidance-volunteering-overseas	/activity/gap-year
/news/2010/september/hospital-medical-healthcare-work-experience-placements-abroad	/category/volunteer
/news/2010/november/summer-camp-jobs-usa-what-company-to-apply-with	/category/seasonal-jobs
/news/2010/december/gap-year-parents-advice	/activity/gap-year
/news/2010/november/volunteer-abroad-medical-work-experience-hospital-volunteering-overseas-before-med-school	/category/volunteer
/news/2010/november/volunteer-abroad-relevant-medicine-work-experience-overseas	/category/volunteer
/news/2010/december/gap-year-advice	/activity/gap-year
/news/2010/november/gap-year-abroad-round-the-world-gapyear-travel-flights	/activity/gap-year
/news/2010/november/tefl-abroad-china-disney-english-programs-esl-jobs-asia	/category/volunteer
/news/2011/february/london-gap-year-open-day-saturday-26th-february	/activity/gap-year
/news/2010/september/gap-year-guide-advice-jobs-abroad-volunteering-tours-adventure-travel	/activity/gap-year
/news/2010/september/travel-save-money-on-your-gap-year	/activity/gap-year
/news/2010/november/student-gap-years	/activity/gap-year
/news/2010/december/volunteer-abroad-south-africa-gap-year-wildlife-conservation-voluntary-work-programs	/travel/south-africa/volunteer-in-south-africa
/news/2012/february/south-africa-conservation-volunteer-projects	/travel/south-africa/volunteer-in-south-africa
/news/2011/april/south-africa-game-ranger-volunteer-course	/travel/south-africa/volunteer-in-south-africa
/news/2011/january/south-africa-adventure-holidays	/travel/south-africa
/news/2011/january/south-africa-volunteer-travel-knysna-and-the-garden-route	/travel/south-africa
/news/2010/october/volunteer-abroad-cheetah-lion-sable-antelope-animal-conservation-projects-south-africa	/travel/south-africa/volunteer-in-south-africa
/travel/south-africa/tours-in-south-africa	/travel/south-africa
/news/2010/august/volunteer-with-lion-cubs-in-south-africa	/search/volunteer-lions
/news/2011/april/volunteer-lions-africa	/search/volunteer-lions
/news/2011/august/lion-cub-volunteer-programs	/search/volunteer-lions
/news/2011/february/bear-conservation-projects	/search/volunteer-bears
/news/2012/march/childcare-and-orphanage-volunteer-work-projects	/activity/orphanage-work
/news/2011/january/volunteer-abroad-orphanages-childcare-schools	/activity/orphanage-work
/news/2011/april/argentina-orphanage-volunteer-opportunities	/activity/orphanage-work
/news/2011/july/orphanage-volunteer-projects-in-tanzania-africa	/activity/orphanage-work
/news/2012/february/orphanage-volunteer-projects-in-india	/activity/orphanage-work
/news/2012/march/sri-lanka-orphanage-volunteer-work	/activity/orphanage-work
/news/2011/april/orphanage-volunteer-projects-in-laos	/activity/orphanage-work
/news/2011/march/inspirational-volunteer-projects-in-argentina	/travel/argentina/volunteer-in-argentina
/news/2011/april/argentina-volunteer-animals	/travel/argentina/volunteer-in-argentina
/news/2011/august/animal-welfare-volunteer-work	/activity/animal-volunteer-projects
/news/2012/february/volunteer-childcare-and-teaching-projects-in-india	/travel/india/volunteer-in-india
/news/2011/april/india-himalayan-community-volunteer-programme	/travel/india/volunteer-in-india
/news/2012/february/india-slum-volunteer-projects	/travel/india/volunteer-in-india
/news/2012/february/india-healthcare-volunteer-projects	/travel/india/volunteer-in-india
/news/2011/july/volunteer-in-incredible-india	/travel/india/volunteer-in-india
/news/2010/december/a-guide-to-volunteering-in-india	/travel/india/volunteer-in-india
/news/2011/july/care-volunteer-projects-in-india	/travel/india/volunteer-in-india
/news/2011/july/teaching-volunteer-projects-in-india	/travel/india/volunteer-in-india
/news/2011/july/care-volunteer-projects-in-india	/travel/india/volunteer-in-india
/news/2011/july/india-volunteer-projects-in-trivandrum-and-kerala	/travel/india/volunteer-in-india
/news/2011/may/family-volunteer-projects-india	/travel/india/volunteer-in-india
/news/2011/february/india-summer-volunteer-programs	/travel/india/volunteer-in-india
/news/2010/december/volunteer-india-2011-2012-orphanages-healthcare-womens-empowerment-teaching-childcare-community-programs	/travel/india/volunteer-in-india
/news/2011/march/india-volunteer-and-travel	/travel/india/volunteer-in-india
/news/2010/november/volunteer-abroad-india-vetinary-work-experience-animal-conservation-projects	/travel/india/volunteer-in-india
/news/2010/august/view-volunteer-trips-in-india	/travel/india/volunteer-in-india
/news/2010/november/internships-abroad-asia-work-experience-mumbai-india	/travel/india/volunteer-in-india
/news/2012/february/india-travel-internship	/travel/india/volunteer-in-india
/news/2011/july/work-experience-internships-in-india	/travel/india/volunteer-in-india
/news/2011/february/india-travel-taj-mahol-trips-and-volunteering	/travel/india
